1111111111111
1P010000P00C1
1000011111001
1P0011E00C001
1111111111111