1111111111111111111
1E0000000000000C001
1010010100100E00C01
1010010010101010001
10P000000C00C000001
1010010010101010C01
1P0000000C00C000001
1010010010101010001
1P0000E00C00C00C001
1111111111111111111