1111111111
1EPCCCCCC1
1CCC1CCCC1
1111111111